Ant   = Semut 
Bat    = Kelelawar
Bear  = Beruang
Bee   = Lebah
Bird   = Burung
Bull   = Banteng
Buffalo   = Kerbau
Camel  = Unta
Cat   = Kucing
Cheetah  = Cheetah
Chicken  = Ayam
Chimpanzee = Simpanse
Crocodile  = Buaya
Deer  = Rusa
Dog   = Anjing
Donkey   = Keledai
Dragonfly  = Capung
Duck  = Bebek 
Eagle  = Elang
Elephant  = Gajah 
Fish   = Ikan
Flamingo  = Flamingo
Fly   = Lalat
Fox   = Rubah 
Frog   = Katak
Giraffe  = Jerapah
Goat  = Kambing
Horse  = Kuda
Kangaroo = Kangguru
Lion   = Singa
Lobster  = Lobster
Monkey  = Monyet
Octopus  = Gurita
Panda  = Panda
Pelican  = Pelikan
Pig   = Babi
Rabbit  = Kelinci
Rat   = Tikus
Scorpion  = Kalajengking
Shark  = Hiu
Sheep  = Domba
Snail  = Siput
Snake  = Ular
Swan   = Angsa
Squirrel  = Tupai
Tiger  = Macan
Turtle  = Penyu
Whale  = Paus
Wolf   = Serigala
Worm   = Cacing
Zebra  = Zebra